4,1,2,3,4,4,4,4,4,4,4,4,4,4,4,4,4,4,4,4
4,5,6,3,4,4,4,4,4,4,4,4,4,4,4,4,4,4,4,4
4,5,6,3,4,4,4,4,4,4,4,4,4,4,4,4,4,4,4,4
4,10,11,3,4,4,4,4,4,4,4,4,4,4,4,4,4,4,4,4
4,4,4,4,4,4,4,4,4,1,2,4,4,4,4,4,4,4,4,4
4,4,4,4,4,4,4,4,4,10,11,4,4,4,4,4,4,4,4,4
4,4,4,4,4,4,4,4,4,4,4,4,4,4,4,4,4,4,4,4
4,4,4,4,4,1,2,4,4,4,4,4,4,4,4,4,4,4,4,4
4,4,4,4,4,5,6,4,4,4,4,4,4,4,4,4,4,4,4,4
4,4,4,4,4,5,6,4,4,4,4,4,4,4,4,4,4,4,4,4
